ncz: xtn dcf
bcn: tpm hqs
nlt: vqr gkj vkq lsn
crm: vvj bsq crn lhj
gkj: jqk kft
zrh: qlh gzs fvs
tsx: vrm vsc bjj dbq cth vbm gmb cjd
nck: xgx pnf fsk ncs lrr
blp: cdm tsp
zzb: jhd
kkc: spp
qqm: gjv zjl cms
fnb: bfm
kls: vth hth
zzm: vtq dfc
hqz: jqv
ght: jpx hcx
gfr: vbk kvr
fzb: nhd zlc gnj
pfl: mgs kpr vfl qpv
gmj: cdm fzq ftd
gnv: qrk scq
mvc: fqn kls brj qrb
hxt: lqv hxb pvb
kjd: szg
gzs: jzc lsr
rmq: hhd hmh jfd
vfp: pqk ddf
lmq: ctn pjj fzc bnm fcs
scq: qvn
qqr: zsk rcf tdp kjk
bpv: gkj vpk
vkg: znm xgx
jqb: npt fpk mcd vbd
dnv: bfm kdm mms
rls: fvs frp cxn
zhg: cls phl
cnh: kxc gnf qfs
xjv: fnb kjk djh kdm
sfg: hzd hmh bmk
fhh: zmn mcz gls
xkf: nxd ppk gjk
gnf: qpg
ggv: xph nkm tkr hdf tsx
lsv: lvf srq cth tbg
flh: xss pzj
zbl: dff
vpx: knj grf
vqs: hjb qnq lfc xdf
kjq: sgb mgz gpb mpx vng hvd
mdz: lpl sxd
bhh: jfh plg xfd gvp
tgj: cjd nng bmq
khm: ltj
hmk: hcr rkt
nts: tnp
khh: xbk lfc gnf
kss: lfc bdp vxn lxz
hkp: pvb ckv xtz
bdp: trd xxc
qzb: vjv nxx rcd kjb dmx
qdq: lmx scq sdx
xxx: cxg ccb tpz zcm
fvs: rnf gmm fsr
zhs: nts vlx
xsz: rhq bmk sdv
czl: sjf
xhz: gcd
dlz: lgg zxh bhs hgq
thc: ftd
kxc: nft
nds: bgd grf rmp
qrb: mnd kjq
mdh: xmd
zph: kvq psj mzx tcv
lbk: ndj qxt jgz hzg
gcz: bvg
nzv: gxh jhx njr
lrn: nbc
cgn: vsm fzx std
sdv: pjx
rtq: zqx jsq
sqq: mkr xls hcr vpx gzs
mqk: blr mzk lhq
jzf: zgd
pnf: sgt znp
kll: sgc cnh gjh
fnz: qff
cqs: vbz vrm hhb jld
kgb: phl bbx
zvj: jfd vpx
rdj: zzm bkg frg
xhg: nvr
gcd: jpb vrt
gbg: tlm sng vrt
msq: rcx xzg mmv jrr
hcf: bkj vcr
psz: zcf mnl jck
lvq: dfk pks xsr hsz tpd
gpv: mkt hjx nnl mkv dtx
zdr: lsn
tbk: qcg qxt lxz qfg
ggn: xsl dqj jkd
bvj: rkm dms cmp hpq cnl rcf
bqp: xrr vsm hhd jjz btf qcz bjk
fmk: rdq ddb gqh vxt hqz
gpg: mtl hxb nmz
sbh: sgv pkq gfr hgs plh
pht: ntg tfg lgt
nqz: vfz gqh dfc xdz
bjj: lss vjs xgj
jhz: pbr zlz sxh ssb
dgc: vxx vvj
hdf: bqh ddn
gdh: rxm dmh fqz
ksl: tfg frp cnl tks
hxd: tgf nxz rfj
dfh: lnj hcc lbx ttq
lhp: ppr rkt xhg
rvm: tfp
gvs: bfr fzq
kdm: plg
ksp: smv tcg spd
pxn: jhv mhg gjv tfm
sfm: mfd
ppt: jbl dhs
mcr: vrn nzk txg
lpg: vhp tpd vxx
qsb: pzc pcl ncx
rcd: tdr
vxr: gbp pvb zgc vdl
tql: ngq ppt dbj nfr
jrr: khs
stx: kvq vjz jvb
rqm: khm vpc jxg tvg
dbq: ffd
znd: mdz fsk sqn lqv
pfb: zlk kqq vpc njb
smp: vxx dhn pmh
scv: tmg sxb ncx fpz
kxr: zhf cdz gvv fsk nxx
ctd: cfv rbf
vgx: rpb
vbq: ptz cxv vqr
vnf: phl nrz
fck: hcv rmb hcn
cdt: rtv qnh lgl tdp hxj kdv
gqb: lds kjn stm slx
bhg: trd dzq glq
npn: lmx nfl ngq lxq
ksh: qpz czq mvr lsf
qgm: khm mpd pfd bqh
gnp: bkj
gxp: pkh jst sbd gpg
ffj: hxx spp lgj lkm
xzr: fpj vbq crs kkf
plh: ddl fpv
zsk: sjf zvj slx
pmv: czq zvz phq ngp
lqp: lrn qnh czl
gqh: xtn jhv
bmk: nfz jfh
tks: gnp rmq
dtx: bfv jqn
vgq: kpr
cxq: fpz pvf fjp vth
fvn: lbx zcf zhd
zzx: pnr szg jks
spd: shp jkf
rkm: gcs sng
knv: qnh qth qjm stm
hfc: jlv
nzz: xxc rnx
nxx: jhv
rds: sgt ltr hkx sjj glc
grf: fqn
pmg: hxd zrx gjp gqz
vjs: tdl stc hxt
ngd: mzg dqm fcs dzb
jgz: qbh nxv ldh vjz
pns: qgq tpm cgq
pnr: hcf bmx rpn
zdp: vvz bpv hgj nnl
xmz: kls vtd ztp zsk
vdb: fpj bgd qxd vdg
ggs: kvr
kdn: hdr bnr xth
sdd: dbg ncz psj
bkl: lpl
vtm: hkp bxj znm
knd: rpb xjt hpq nzk
rhq: zss
bcr: vkf xdh jfd
hxv: jdc tfg
fxp: tdl ldh qrg mkd
kfm: ftd mkd qfs
sch: ljt txg vkp mkt
vqr: fbz
npr: bcg sxb qpz jqn khj
qxp: vqr
gds: sgl bgf zbd dsk
lrp: fnb mzq xrk
kjh: nlh
fpg: hvp bcq hpx
mnc: vtm fpg bnj
mzq: bgk njr qlh
zss: xgq pgp jdc
hsd: ght vgh
ppg: lsr xjb
vdg: tpd
kxz: jdq vzd bgg tdd
jzq: zvv dff
tdd: dxv rrj fgl
cmh: njn vmb
prn: bnm
fjr: ltq zlh jgv hvd cdn zdr
mtk: ngq ctd vkc gvv
drr: qjf mmv nbh slg tjz
bld: vnm njl dfh gnv
kqq: dlp rxc mhj
vlb: tpd qdf mmf
nvf: rpl kgf fqg xlf
ckq: rqm nrz
hvb: psb kvq
slk: ftd kcc
lgl: lzl
lqq: lhq
nmk: xft kcc kxc pvb xnl
ksv: vlh jmm qdf bzb
qjh: grt ctn ctd chm
ljf: nqp fpk
zlk: rnx lfx bzt
tdp: dtf
khf: zhj fpv
kgc: kch mrv qvq zzb
vhr: hqn lbd qvm
ccr: fjm xgx
hcj: tcv gjh
sgt: lqv
sdr: ddf jbs nts
svv: gvp cml ptz
jxg: thb slk
fsr: qpz fpv
mvr: czl
xpc: hcn xhm crn
hzs: qrb bgf vsh bpv
jfh: lgt
grl: qcg dcl
zmx: mtg rhq
xcm: kch
zhr: hln bjc bfm btz hxj
nqg: nqj vqv dfk zrx
xkv: nlx
str: jrr kjn vfp
tbb: trd gbp vnf
xdj: frm gmn gnd
pjl: rnx vgh qlz
pks: kjd
fqx: zlc hcf gmn
rhz: tdb
gnj: hdr
vrn: mms bxf
tpb: qrk gnv lvf qbh
mzb: jfd hfc lzl
zrx: krs
xpd: kgq vkq
fnm: zdp gzs kbd vpj hjs
lpb: zvj qnh zcg mhc
jrg: cjp cdh glg pxc
hcq: jbf klk lsb hfc
xqb: gvv bht dzb mdz
dzq: lfq rbf
dgv: trd pjq rxc
lnj: jvc kgf vxn
gfq: vbp fmx kll nvp
dtp: zgd
dqd: bzt gvs drq nft
gzm: mfg sgb bvg xcm
fjq: ltb rdj jqv
hcb: lbd sxh prs zlb ssr pnq
hdl: thk xdf vkc
qpg: npv
nlh: qph
qvm: trd
ddr: bjk zvv vhp tjj
tlm: rvg vnc
zmn: btc
jgb: xph
rpc: vbs gcs hft
khs: xtc
djg: vkc psj znm zgx
zlz: xgx qcg bhg
pnq: scm
thf: gxh rcf vqr cgj
lfh: qql gpb rhq lvc
hsm: mfh ntb mqc qlh
szb: njn ddt ppk ddk
vgr: rvg rbr zlc
pjk: mlb
brm: lds hcn zxh ptz
hzv: zdr ddt rcx jsq
zdd: sdv kdm hmh
qph: kmd gmb mtl
qvq: jmm
rgn: mpt xtj jbh
tgb: dmh
zfq: czl
qmf: vck chm cjd
pfd: lzf ndj hcx
xjd: vdh tcg fcv szc nfr
vdl: kmm
nss: bbx
kgl: ncz jkf jkd tbz
kdd: stm ztp xhz xpd sqd
mkv: bhz nps mmf
pzb: jzq cxn mgl vng
plv: rqk fxj bkg rng
jdx: dcl hqn fsk
mrb: gnx csb ctm trf bfv
pkh: rhr tsd hkx
mzk: scm
trm: vxk mzb ncx xhz
qmj: mnc dvz dbx snv fjb
xnc: gjv hpx sxv
lvf: vck
hcx: npv
xhm: tpz kpk ppr pmh
cdz: bfr sts
nvr: jks
rfq: gsh fvs jgv
qxj: jgm zhg zbc drq
bdb: pjk lch rrs
fmh: rnx
vzd: ctn zjk
mhj: zbn
cdn: hln hft
xfk: xfn rbq phq zzq
hqm: vsm
zxh: vjg vfp
jkd: sxd
drh: kch cgt cgj ddf npt
tjz: kdv frm
pxk: vqr hhd phq
qdj: lxz fzq tgh qnq
zgj: jqg vkc mxd
zsh: bnr
xgv: nxz gjk vkf
prp: frj dxv kmm
hck: jtn mgr csr dgk
vcv: vzf nfz ccf
hvp: qsc sjx qfg
qth: hxx
bqk: tpm smk knf lkm
lkb: msp vgr mpx xct vqv
ngp: str
cxn: ntg gmn bgk
vmb: kzm gmm bkj
vjt: lbk qjj htg lpl jck
hxk: jnj std sjs pzc mrv
dnx: rng hxb gph
vrq: dqz hhm
xsn: dzn
lch: stc vjv
bjk: gsh
mhb: sfg xlb xpd nzk
qrx: frj rlz ltj
pdz: vkg tdr qmf
jlv: szg rcx qql
dmh: kpr
hnc: qxt
htn: sdr pgd bzb bfv
ngq: qlz
thz: vpc chv
pnl: ghl bld
mcd: ctk cnl
vpj: xzg tjc cgn flh
nnc: qnp kzz rsr xjf
zrt: qsc cgq
cmb: dgt szh ppg npt dgc
zvv: lgl
jzz: sjs cnl ptd flh
nxb: qbh rkb xmd nsd
vqj: dcf zbc vxm lph kzr
zsd: lgg
qjf: nhd zsd plg
clz: bmx kkc qxd gcs zzb
dzb: cnt
mhg: nrf prk
pzp: txg xnf xkv
jqg: tsd
srr: cgq qpg
mht: zbd hgs
ndj: bfr
kjb: thk
jbl: rfb zhf
srs: dgk bfr hsd
psb: gpq
sdx: knf ltr bpd
tsq: mhb gmm zfc mmf
jjz: rmb
vdk: dnf qqn knh dgt
jbh: jck qbh
kch: lds
dlp: njb gqn qsc
hcv: zqx tjc
pgx: qcp dnf bmx zqx
qrg: zjk
cfj: xtj
spx: kdm ztm jsp qsl
zkf: zsf tfk xns
kzz: jhd vcr
hjj: nqp pcl gnp
cfs: rqk gpg lvz ghl pjj
pgd: tss slx
fgd: snk qxd kjd mht
bmj: hsg tbb hcj
mpr: pxx jgh jgb mnl lvz
tqk: hln hjs pkq ptd
nqm: rst xts cnt tvg
pkq: xnf
kzj: hbs mdz kjh
xsr: xrr bmx
tdb: xtm
lzs: tzd nqz lzf qff
hjb: kpr lqq
xjc: znb bsq njn zkd fzb hvd
szp: fjm cjl tkf vvc
sqz: tvc nsd jcv
tjh: ngd vsc bdp xxc mpt
bqh: tgh
sgb: dsk
jbf: mbh lrn hln
vtq: jmn gfc gpq
hxj: gdq kdv
cnc: kjb nqz zgj bkl ffd jgb
lfx: lkd
dts: qnq cls jpx
lph: lqx cfj pqd khm jqv
gbb: psz fml nss xkn nxb
cfc: xcx njb
knh: lhj rmp ssv
ftm: ckq lmq qfl fqz gqn
lhj: zsq bxf
fkd: qfb fdv bjk sjs
rst: svf jgh jtn jgb
sxm: cls jqg chm
smz: vbk frp kdj ntg
csr: dzp
dvq: xts qfg cdz vgq mzx
tvx: tdp gcz
fdk: lgp kft rtv gcd
gzj: lbd
nrc: rhz kdm bnr
bnj: qsq cfh hxt qsc sjk
vkp: ncx hnm cgt xsr
smk: jpx nfl vdl
fzc: xdf vnm gxj
hlv: nmz tld fdq vbr qqs
jmg: tss mjg tjz cfm
ljt: prq xfl nps vlh
mcz: tfp fmh
pzk: hdl znd thc lkm
qlh: mtd
rfm: fmt pqg smp
xgj: cdm rlz
bmq: rxc dks
xmd: cms
nxv: dmh rbs grl
bhs: nqp
vrd: nxd lpb str kdv
thx: gxh fdv xtm xth
sjs: lgt
zlh: jrf mfg msp
qgz: dxm znb lsb qpz
mmz: nqz pjl xnc ltr
rgl: cmp gnj xkv pjx vsq
vpk: lgt
srq: bbq cfv
slg: hqm tpz ccb
zhd: sxd xsn mgv
gsq: mfg hjs
rbs: sjx
sjb: sxh
jmn: dcl
nrz: stc
jld: xsn hqs lkm
lfq: znp qfg
zdl: cjl jzv fnz tbb zjk
gnx: mgz trn tgl
jjl: nvr nbc spp
nsc: rmp hft hcv sgl
jkm: qsq prk
nmz: thb
hcc: tgh
jdc: zmj crn rnf
mhc: qvq dxm gtf
gzp: vck dtp jkf rdg
hsz: dgc mtd
ppr: lgj lds btz
kfr: pqk
ddl: hdr fbz
mdn: rrj kgr jvc rtp
klk: crs znz
vsc: nhg vgh
crj: ctn srs xtn
krs: zvj vng szs
bpd: dbg fcs mgr
vch: fmh fqz mlb lvd
ccf: jnj
kgr: nng dzh sgt
lmv: ggs pmh shd sgl
kmx: qpc
fvr: pnf zhf njl jkm
pqz: vvc jjg sxm
nfr: kvz
bbr: cnl xrs lgh xjb
jtd: lhq ksp gdh hnc
xlb: jdc xkf tdp mcd
kmm: pjq
nqj: xzc hlq
jsp: hxv tgf kdj
vfz: bpd qsq
psj: clm
tjj: ptd
pzc: ppg tfk cpc
ljj: zkb vpk xhm fmt zss
cng: bxd
rdg: jxg tkr sts
fxg: vlx sgv
tbp: hgq vsh gvg hmk lzl
bzl: fnz fnc fvk kzr
dln: rvt bcq hkr cjl
zkb: mfh kdv qth
nbd: vrm tcv
tbz: gjv hqn lkd
ptz: rmp
rfb: svf
scm: rrn
tlg: kcc
qfs: mgv lqv
qpv: hbs
dgn: gjk jqn cxv lgp kqz
hjz: qcz rkm hdz ntg hlq
trn: jnj vhp
vng: lgp klk qth
nxs: mvr rfq tlm pgp fkc
hzh: zhs xnf
cbf: xsz nrc szs fsj
hqs: jvj cng mkd lfx
xnl: vdq hsg
rng: hrx xcx xdz fxj
jmv: bzb bjc pxk
qdf: lgl
glg: cth jpx dzq
hqk: qdm rcd bkg qph
qtl: dtf xtc zhj
zsb: kjd jpb pqk
jzj: rxm zrt tlg
jbs: grf zsh fhl
pbp: xhv cxn snx xcm
xfl: lgh fpj tvx
bcp: mgq bxd
pcs: ddn prk qcg lmx
nlx: tdp
mpx: dff
jvc: lvf xbk pfd
xfq: vkx tfq
xct: zss ffj jmv
czq: bkj
msh: jvj xdf dsf csr
rvt: tht btc dxk
fgh: bgk gnx pnt
std: dff xjb
jgm: jbl bcq
rsr: plg
kft: mfh
rvg: pzp nhd rtv
hpq: nfz
lvd: bvt jzj
gls: hkx
xbm: nfz jhx
tht: kmm rrn
fkc: zbd fpk dsk
jhx: tnp nlx
htx: ndj cfc jfz jhv
qcz: rpn vjg
vvg: pnx fsj fmt jks bgk
rcr: njq hnm dnj rsr
zbn: zbq
rsz: zvv kft hxv mnd
bhz: brj dnf
prs: hpl vfl tlh fvn
rfj: xhv bjc xns
tfm: mpt csr
mmf: nbc bnr
ctm: vnh svv nbh
khd: vgq chr nhz vgz
njq: djh rzt
qbj: stx
fjb: jjg bjg tgb jdx
rbq: szg
btf: kmx
vbr: nfr hkr kmd
hzg: hdf pjj fvj jfz dks
tqd: dkz gfr smt fgd
hpx: vxt snv
dsf: xsn kvq rvt
xts: vgz
fnc: dks mhj
qvn: thz nhg ngq
jpx: vkx
tnp: mkt
dvf: pzj fsr vjg xls
zmg: tsd mgr mhg qvn
rqk: lpl
tlp: pqg smp hjx dsk hdz
phc: nlx hzd vbq xcm
cfq: pxx psj prk fzq
gcs: cmp
nvx: prk xdz
gfc: bnm
vbm: zbn dhs thz kvp
bbb: stx kcc frg
brp: pzc sqd zss tjj
fxj: gmb xph tgh
ddt: mfd spp
qtt: grf zrx xgv mkr
xft: psj jcv sgc
mzx: shp thk
hmg: kfx nps ffj
xxd: xbk dks hbs
znb: sgb
nfl: pjq
nnh: xpc zcm pqg nvr
zpt: rxd lgl mms gnj zhs
frh: jhv mvd qdq lxq
gtz: frg vfq rdj lmx
mzg: nss mnl
khj: zqx stm
pxc: qrk vbr jzv
shj: prn mhj vrm ndj
hvd: tqk
zbq: xxc
plt: tgb qlz hqz dbg rbf
lmz: jgz psb ftd bkl
qnt: btz cmh cfm jbs
mpd: mkh gxj
frb: bkn lmz jfz dvm
cpc: hjs
rcf: kjk
vsr: rpb crn mjg szs
njb: hsg
xdz: lqq
pxb: ncz grt gjh bht
nlc: gpb hzh lsr grf lpg
hpl: sts
qfg: ltb
dhz: kgb qff mlb
dnj: frm lsn jfh
snx: bkd tfk
mkh: dbj rkb vgh cps
qjj: qvm xxd blr
jcv: chv xtj bbx vgz
pgp: zbl
kbd: zsf bth vjg
zlb: blp mvv tlg
hrx: zbq phl
rdq: dts
zfv: qpc xgq xzp vbk vcv
cgt: gcz ctk tvx
jhd: gpb
tss: pqg
rhr: nft fnc
csc: glq
nhd: rbr
snl: kvr kzz mbh ppk
dgz: xth cxn qvq njq
ztp: sjf kpk
hhm: zbq rxm
fvj: jzf fpp
ppp: knv zkd qsb
ftx: khj tks nqp
jqv: glq
gjh: rlf gld
xdh: plg njr
csd: jmm bfm zsb sjs fms
xfn: hcn htc zzb sqd
bbv: vlx tjj qcz pht
cdh: thc qfl
qgq: kmm cgq sjx
pld: hjj hth kfr zmx
dmd: pks fxg xnf zsh
mtp: jvj mdh grl
hxb: snp
fdq: bbq qfs flb
lkn: shd kjn smz sfm
fnh: xcm vnc hlq xzp
hkr: fvk cms
srj: drh pgd ggs kdv
tvm: fnz sjb qnx znm
tkf: cls tdr
zzq: hdz rbq hmh fqn
xzc: szh xtc vcr
cfh: mkh rxc xfq
xtz: mcp gnf jtn
chf: vzd gls lqx qnx csz
xdf: kkm
qrs: vxt
xnv: lbd zmn ddb qbh
hbs: sjb lfx
knj: rpn
rkt: xtc
xns: khf
dbs: mvd hqz dgf nkm thc
dkz: ctk
dvg: mzk ccr ppt
jst: ldh dhs bht pjk
hqp: tjg drq bdb zgx
pjc: mzk pjk
hvx: sst jzq shd pzj mgz
txg: jgv vkq jrr
vsh: nnq
vqk: lxq dxv hnc hpl
nxd: zlc nqj qfb
bgg: dxv kjb hct
hgj: bmx fxg
sbc: zhs qpc jzc vgx
fqz: nlh tcg
tnj: qdm bcp bbx bqh
xzg: hxx mpx
mbh: rpb szh
tjr: cmp czl kfr mtd
rmb: fhl nqp rzt
ppk: hmk xkv
hnd: zzx xdj dsk ppp
sng: khs
vkc: kvp
mhv: ldh bkg flb
gjx: pjc nrf gxj hct mgs
bkd: lsn dgt lld djh
fjv: bvg bsq
pnm: bkl dvg npv jtn kzj
gvb: gvv jmn tlg nng mxd
ktm: fck cnl xhv
hdk: vkq nnm kzz zsd
ddn: vxt
kgf: mzg hct
cms: stc
vzf: zsq
gmq: xjt ptz cxq jpb
pqj: bzf skg zjl tdd qrs tfp
hsc: tqk zhj knj
bst: sjb dfc chr jvb qbj
vxn: jqg
jck: fgl
csb: nxt mrv hmg bsq
trf: zsd fbz
nvp: mtl mgv snv
vzn: gcs szs kjn
brj: pqg hth
zgx: nsd
kfb: qrl hct ttr dzp
jqk: gxh rkt
rrv: xts rpl zmn czz mgs ggn
sqd: dxq
vgs: xpz xjb psb
qfl: nfr lss
vbd: tdb cfm lhj fsj
rlp: plh zcg xss
sqn: vkx qlz btc
pvh: zbl fms hgq
tmg: pgp zhr mgz tnl rtq
xss: mkt
zrd: dhm jzf vgq
hjx: mmv
lgg: jmm kvr
tlh: srr qfg gnv
xth: nvr zbl
kfx: rtv hdr
pjm: vhk qnq dbg gph
xtm: kmx
fdv: fpk
fgl: npv
vvd: qzd nds jsq vrn
gjk: ngr
tnl: btz tfg lgg
dhn: lgj
szc: dzn mgq
fjp: qqn qxp lrp cmh
ckv: chv grh
jfd: xss
skg: cmg mkd fnc
pkm: pvh rsz vpk kgq
gnl: jjg dzq scq kss
cmg: qqs
dvz: nvx fjq fmx
lsq: kkc qjf jjz
tpm: bxd
jfj: mnl fvj tkr vjv
tfp: kmd
grt: nrz ssr
gfz: rbq vrt lrn fdv
fsf: jrf vsm
htg: zbq
vfq: ggn nrf bmq
xrs: mjg nbc lgj nqp tfk
xrk: kqz
gph: nbd zgx ltj
jzv: lqq ght
qjm: rhz kfr
cjp: rzq dzh kfm
gsj: zrd nbd vrq cnh
xcl: tbp qjm pht zmx
jvb: tkr cfj
nlp: dfh frj crj tsd
skn: blr nzz lxz gvs
vqv: lpv zcm
hhb: ndj dmx
qqf: cfc mtp rrj
vbz: hkx xsl dzp
tfq: dtp grh nmz jbh
tbg: pnq mss tsp
kqf: lrn kkf sfm ltq
rzq: bnm ght qqs
fhl: bfv rhz
hpd: hqs mkh sxv qpv
ljb: hpl plt prn
gqn: jkf
chm: dbg
gjd: jjl njn fpk zdr
ljl: mlb qbj bqh btc xhg
flb: kkm
zlc: ddk sgl
mcp: rcd
cgj: jhx fpk zsf
fqg: spd tvg gmj
msz: csr jpx mdh fcs
czr: tdl mgv ndt
mts: ttq ccr cgq hnc btc
gnd: ccf ngp bjc
dqj: gpq vdl rfb ddb
nps: shg
qsq: kvz
fml: tzp sjk chv
kjk: crs
xjf: nnq kkc lds
jfz: snv bcn
ncs: zzm nzz csz szc
gld: grl xgj nss
hmr: fgl ngd bbb pjq zgc sxv
pnt: trn mcd
czz: rbf srq lqg
stm: kdv
pvf: phq mkt
mls: kfx shd mcr snx
lzf: ltj mkd
lvc: cdn vqr ftx hgs
glv: kkf fpz gsh kpk szj qnp djh
bkn: zgc lkd mpd
qzd: szh ltq
nfh: dcl hjb gpq sxh czr
sjj: nfl lfq kxc
fcv: dzn lqq ncs
vlt: pgc xls rjf vlb pxr ltq
zfc: smz frm bxf
smt: tpz fgh cxg msp
mcc: thk pnl sjx
nxt: nxz
bxj: kvp zhf gzj
qdm: rpr dmx
vbs: dfk njr
lld: sdv lsb fjv
pxr: sdv kmx zsh
dhm: btc rvm
lgx: bfm btf xss dnj
nnt: fzq mcz tfp
tvc: lqx ltr hqn
qff: vvc
cnt: trd cjb
qqn: vvz gmn
szj: hsc hfc
zgc: vkx lqx
cps: ghl jmn thc
zcf: nxx zbn
bgd: sgv rpn
qcp: tdp pks
rpx: vvd jlv khs hgj gjk
hft: bzb vtd
jgh: ngq
dqz: cjb ttq
pcl: vvj gtf xtm
gpb: zsq
vjv: thb
mvd: dbq kkm
mrv: pfc zmj
xfr: pmh qpc jpb szj
ddk: qfb rzt
lxq: xpz
vlh: xgq mfh
lfc: xcx xnv
dcf: xpz vtq
cxv: kdv
lrr: vvc tfq sjk pjc
pnx: pgc vtd zkf bhs
ccp: nlx dxm fjv csd
pqd: zbc xtn
fpj: lrn xdh
fmt: qfb
kzr: bbq mvv
hdh: dzb vxt rlz fmh
qnx: rfb
dlq: rbs tgb lch tvg
qql: nts tnp
bcq: lkm
njr: lsr
kth: mtg ktx lpv sfm
cml: snd xrk
bjg: cmg pjj
nvn: qgz nzv nxt vhp kch
xkn: gbp xnr
dfk: sjm
mkr: xrk vnc fkd rkt qxz
mxd: xbk lxq
vdc: cjb fdq pxb ngd
gtf: zfq hpq zbv
smv: sxv
bzf: vck rnx
ccb: krs
cjd: kgb
gmm: vvz
xlf: smv ncz
snd: zhj zsq xth
snp: glq ftd
gzk: zjk zbc rdq
ntb: ngp rtq drr jqk
vpn: rrs ngq tjg tdr
rrs: mtp rrn qrs
tzd: cng dhm sbd
xph: jvj lkd
msp: ccf fnb
lzp: gbg hgs gcd vgx
fpl: vng vzf lqp rlp
sqx: grt rrj ckv ljb
qsl: mht gsq lzl mms
slx: vcr
fmx: gvv
sxb: mvr nxz kqz mmv gmn
lgp: pvf
fzq: vkx
ktx: jhd sjf kpk hhd
cth: tht
tcg: cls
lqg: qrl stc hxt
dxq: npt xhg mjg
dms: xjt kzz tjz
snk: rnf xjt
nbh: ccb xbm
qxz: fms vvz pxk
vbp: fvk kvp knf
rhs: fsr ddk xbm lsq
ddf: rnf
gvg: ptd
rpr: sjk xsl flb
fvx: rdq bzf gmb nxx hnc kxr
vsq: rsr ztp bxf
bvt: shp vjs
dmx: ffd cfv clm
kds: kmm qqf kkm
jpb: rxd
fpz: cpc
qkd: dzh psb hsd hbs nvx
mss: nsd ckq gzj pqz tkf vgs
hsg: ldh
bzt: gbp
mzv: fvj vrq qrx rlf
nng: kkm
zjl: ndt clm sdd
mbr: qcg cps ltb
bjz: rkb prp hhb mhv ctd
mnn: rhr srr mqk xcx
pbr: qrk gxp vnm dhz kjh dgv
dvm: qrg rvm mtl bdp
tjg: mxd xkn nlh zgd
hnm: nnq
sxr: kjn hcn pks zbv
tfb: kds ssr mzx qvm
gqz: ngp znz hnm
sgc: trd nft bbq
clm: dzp
gst: sxb hcr gcd hxx
qnp: dtx zkb
dbx: fmx pdz dnx
qqs: dks
hqn: lhq
vnx: vxx lsn vdg hzh
jrf: ncx kqz rpb
lss: blr
htc: zdd shg pjx
nnm: cxg nnq djh
ndt: thk csc
rkb: dmh dfc
mtg: btf
zsp: vnh ddk dgt hgq
rpl: pns zhf
vnh: zfq dgc
nfn: tbz dlp qnx lkm
bgf: tss mtg vgx
chr: xdf blp
ztm: nxt lmv pvh zrh
tjc: qpc
fpp: ddn
prz: nqj xjt pjx kdn
sst: gcz hqm
hhv: tss mfd pkq pzj fms
zkd: zzx dnj
ttq: ltj
ssr: cjb
lzd: hcj vhk jkd xlf prn
rtp: qnx vpc nbd dzh ttr
vxm: vxn dtp vvc
gvp: vhp fpk
pfc: vtd fqx
mnd: dkz
dxt: hth rtv bvg rfm sgv gnp bhz
mfm: snk gcs pnt tjc qxp stm
rlf: rbs znp
kxt: qgq hqs htg lmx
fzx: qjf dnv cpc
zcm: rzt
vdh: hcx rvm fpp nfd
zxn: ljf jks zdr hsm
fsh: mpt vhr bcp stx
cjl: mdh bdp
vfl: cfj csc
fnf: lsn vvd vdg rxd
hlt: hhm ckv bjg njl nvp
mvv: stc ltb cnt
nfd: qrl xmd
hdz: rcx khs
gdq: pxk vth
vlx: vqr
mgq: tdl vjz bcn
nhg: kkm
srn: kfx jgv dlz vzn kdm
jmm: fbz
xzp: sjs mtd
dfc: mcp
jhn: grt dzn gls snp
kkf: rxd
nfb: rpc cml mnd xbm hmh
pmj: pqd bmj xfq kvz
fsj: shg
hhc: mzq sst cxg xpd
jzc: phq
lpc: pgc zvj rls bhs
rxn: tkr sqz tlg jkm
bcg: xnf pfc xdh
prq: trf hqm ktm
qxd: ngr ddl
fcl: gfc lqx lvd svf
tld: pnl fvk pnq
kzm: mfg dxm
glc: mlb zhg mkd
hjh: ncs hvb hjb jgm
zcg: knj xhz lhp kzm
sbd: tvg thb
mgl: hsz mfd pqk
dgk: rrn spd
ttr: prk tvg
znp: dbq
mgs: smv qxt
kjn: qzd sng cfm
xpz: kvz
cfv: vnm rlz
hcr: zfq
tsp: gzj lhq
hdd: qcp knv jsq djh dhn bnr
pxx: rgn dqz
xnr: lss vnf bzt
dqm: vkg xph
tvn: qvm nfd ckv
zbd: hmh
mqc: vvz vvj tdb
dbj: sts
rbr: znz rtq
zvz: fpv bcr ljf
lmx: csc
xsl: dhs hrx cng
nkg: dbj vfz jjg lnj qbj
ddp: xtj slk nng hvb
vdq: prk fpp kjh
vxq: vsh ccf rlp kzm
tgt: nzk vbs gsq jhd pzj
vxk: gvg xns nfz
nhz: fhh qrl bnm
bth: bjc cpc mtd
rjf: jqn xrr dnf ggs
nsk: xrr frp ctk lzl
hfm: gvg jzz csd knd
zmj: khf lds
tcv: tgh
tgf: xhv fpz
ssb: scm dqm khh
ngr: jmm dtf
ghl: hcc
nnl: pqk ssv
bfp: qxp vvj vth hjx
gxj: nrf
pvb: frg
fjm: qqs
rpd: ffd cmg npv shp jqg
jtn: cms
lsf: pjx jnj zcm
zjf: dvm frj trd mcc gzk
gjp: bnr znz rtq
txl: sts mgr qqm szp
svf: qpg
sjm: hlq lsb
jdq: qrs vbp jgh xnl
tpd: fqn cxv
qcf: szs jjz lpc lgh
nkm: sts cjd
njl: zrt
rrj: tdr thk bht
bqg: dhz tgj ndt bvt cdh
xkr: qxj bzf gqn gdh
gsh: dtf crs qdf
qfz: tfm qrg rxm zgc
vkf: gfr lgh tfk
jkf: bxd
ssv: vnc sjm
qmd: znb gpb gdq fsf
xhv: xjb
tgl: khs kqz zsf
vbk: czq
lpv: fjv shg
vhk: pvb hcc
kdj: fpv gpb
tzp: htg jkm mbr
bdj: tnp lld qtl dkz zsq xls
csz: sxd vjz
cmx: cdm nnt lzd qmf
htb: snp qpv zlk rqk knf
lvz: gfc grh
xfd: dhn pgc fdv hdr
dgf: tvn jzf nss
ddb: fjm
lbx: gzj kmd
dxk: vgz mcp gqn zgd lhq
drq: nhg
vrt: grf
lkm: grh
zbv: vsh vnc
xgq: kfx jzc
kgq: vzf zbl
hzd: fsf bmx
